Althusser - Machiavelli and Us
Bendis - Alias vol 3
Bendis - Alias vol 4
Brunhoff - Marx on Money
Duncan - The New Depression
Eagleton - Marx
Elliott - Althusser: The Detour of Theory
Freud - Beyond the Pleasure Principle
Freud - The Ego and the Id
Galbraith - Economics in Perspective
Hardt and Negri - Commonwealth
Johns and Kubert - Flashpoint
Kagan - The World America Made
Lewis - The Big Short
Machiavelli - The Prince
Mason - Postcapitalism
Pollack and Olen - The Index Card
Posner - The Crisis of Capitalist Democracy
Ranciere - On the Shores of Politics
Reich - Saving Capitalism: For the Many, Not the Few
Shiller - The Subprime Solution
Anthony Lewis - Rails Crash Course
Bigg, Katz, Klabnik, Skinner - Rails 4 in Action

Sarah Leonard and Bhaskar Sunkara - The Future We Want: Radical Ideas for the New Century
Althusser - Philosophy and the Spontaneous Philosophy of the Scientists  | Verso | 2012
Michael Heinrich - An Introduction to the Three Volumes of Karl Marx's Capital | Monthly Review Press | 2012, Original Publication: 2004
Thomas Frank - Listen, Liberal: or, Whatever Happened to the Party of the People? | Metropolitan Books | 2016
Charles Wheelan - Naked Money: A Revealing Look at What It Is and Why It Matters | W.W. Norton & Company | 2016
Carsten Strathausen, ed - A Leftist Ontology: Beyond Relativism and Identity Politics | University of Minnesota Press | 2009
Theodor Adorno - Minima Moralia: Reflections from Damaged Life | Verso | 2006 (1951)

Duncan Foley - Understanding Capital
Mark Waid Daredevil - vols 2-4
